..^..>*###|//
..^..^-///$//
,,@>,@-///$//
...^..-<#=&//
...!(,*&/$///
....^.-//$///
....^.-<#+##/
,,,,@.-$/////
......-$/////
